==========================================================
=                                                        =
=                                                        =
=                                                        =
=                                                        =
=            2                                           =
=                                                        =
=                                                        =
=                    =======                             =
=                    =     =                             =
=                    =======                             =
=                                                        =
=                           1                            =
=                                                        =
=                                                        =
=                                                        =
=                                                        =
=                                                        =
=                                                        =
==========================================================
